id_product,id_bundling
p_001,b_001
p_002,b_001
p_003,b_001
p_004,b_002
p_005,b_002
p_006,b_002
p_007,b_002
p_008,b_003
p_009,b_003
p_010,b_003
